<html>       html开始结束
<body>       网页主体
<h1-h6>      六级标题
<p>          一个段落的开始
<br />       换行(不产生新段落)
<a>          链接
<img>        图片(无闭合标签)
<hr />       水平线
<!-- -->     注释

文本格式化标签
<b>	        定义粗体文本。
<big>	      定义大号字。
<em>	      定义着重文字。
<i>	        定义斜体字。
<small>	    定义小号字。
<strong>	  定义加重语气。
<sub>	      定义下标字。
<sup>	      定义上标字。
<ins>	      定义插入字。
<del>	      定义删除字。
<s>	        不赞成使用。使用 <del> 代替。
<strike>	  不赞成使用。使用 <del> 代替。
<u>	        不赞成使用。使用样式（style）代替。
<pre>       预格式，保留空格换行 

计算机输出变量标签
<code>	    定义计算机代码。
<kbd>	      定义键盘码。
<samp>	    定义计算机代码样本。
<tt>	      定义打字机代码。
<var>	      定义变量。
<pre>	      定义预格式文本。
<listing>	  不赞成使用。使用 <pre> 代替。
<plaintext>	不赞成使用。使用 <pre> 代替。
<xmp>	      不赞成使用。使用 <pre> 代替。

引用、引用和术语定义
<abbr>	    定义缩写。
<acronym>	  定义首字母缩写。在某些浏览器中，当您把鼠标移至缩略词语上时，title 可用于展示表达的完整版本
<address>	  定义地址。 在某些浏览器中，当您把鼠标移至缩略词语上时，title 可用于展示表达的完整版本
<bdo>	      定义文字方向。
<blockquote>定义长的引用。
<q>	        定义短的引用语。
<cite>	    定义引用、引证。
<dfn>	      定义一个定义项目。

样式
<head>      可在head标签中使用<style>定义一些样式属性，对网页的标题，段落等进行定义
<style>     内部样式：可以用在<head>标签中定义网页各个标签属性
<link>      外部样式：可以用在<head>标签中，链接到外部样式表。注：<只能用于head标签中><html中链接标签无结束标签，XHTML中必须被正确关闭>
style：     内联样式：在标签中使用
<div>	      定义文档中的节或区域（块级）。
<span>	    定义文档中的行内的小块或区域。
<font>	    规定文本的字体、字体尺寸、字体颜色。不赞成使用。请使用样式。
<basefont>	定义基准字体。不赞成使用。请使用样式。
<center>	  对文本进行水平居中。不赞成使用。请使用样式。

图像
<img>	      定义图像。
<map>	      定义图像地图。
<area>	    定义图像地图中的可点击区域。

表格
<table>	    定义表格
<caption>	  定义表格标题。
<th>	      定义表格的表头。
<tr>	      定义表格的行。
<td>	      定义表格单元。
<thead>	    定义表格的页眉。
<tbody>	    定义表格的主体。
<tfoot>	    定义表格的页脚。
<col>	      定义用于表格列的属性。
<colgroup>	定义表格列的组。

列表
<ol>	      定义有序列表。
<ul>	      定义无序列表。
<li>	      定义列表项。
<dl>	      定义定义列表。
<dt>	      定义定义项目。
<dd>	      定义定义的描述。
<dir>	      已废弃。使用 <ul> 代替它。
<menu>	    已废弃。使用 <ul> 代替它。


表单
<form>	    定义供用户输入的表单
<input>	    定义输入域
<textarea>	定义文本域 (一个多行的输入控件)
<label>	    定义一个控制的标签
<fieldset>	定义域
<legend>	  定义域的标题
<select>	  定义一个选择列表
<optgroup>	定义选项组
<option>	  定义下拉列表中的选项
<button>	  定义一个按钮
<isindex>	  已废弃。由 <input> 代替。


按钮
<button>    网页中添加按钮，并通过属性设置点击按钮操作，如onclick属性为执行一段JavaScript (<button onclick="copyText()">复制文本</button>)


